                             
                             
                             
                             
                             
     ###########x#######     
     #..............#..#     
     #.................#     
     #....#............#     
     #.................#     
     #.................#     
     #.......#...#.....#     
     #.................#     
     #...........@..#..#     
     #.................#     
     ###################     
                             
                             
                             
                             
                             