###########x#######
#.................#
#...####......##..#
#...#.r#..........#
#...#..#..ooooooo.#
#...#........ooo..#
#.................#
#......##.........#
#......##.........#
#.............@...#
###################