###########x#######
#.................#
#...####......##..#
#...#.r#..........#
#...#..#..ooooooo.#
#...#........ooo..#
#.................#
#..@...##.........#
#......##.........#
#.................#
###################